



          
                 C   255,20 ,30
                 SO                                     ./textures/greystone.xpm
NO     ./textures/eagle.xpm

                  
                WE ./textures/purplestone.xpm
                           
F  000, 000, 00




 EA          ./textures/red.xpm











1111111111111111111111111111
111111111000200000000000011111
100000000000000000111000100001
1100001000000000000000000011101
100001111111000000020000111111
1111111000000000W000000000000
111100000000001100000002000011
11000000000001111000011111111
10000000000011100000010000010011
1100000000001110000001000N01111001
110000000001111000000100000111
111111111111111111111111111111111
