



          
                 C   255,20 ,30
                 SO                                     ./textures/greystone.xpm
NO     ./textures/eagle.xpm

                  
                WE ./textures/purplestone.xpm
                           
F  000, 000, 00




 EA          ./textures/red.xpm











1111111111111111111111111111
111111111000100000000000011111
100000000000000000111000100001
1100001000000000000000000011101
10000111111100000010000111111
1111111000000000W0000000000001
111100000000011100000001000011
11000000000001111111111111111
11111111111111       111111111111111
10000000000011111111110000010011
1100000000001100000001000N01111001
11000000000111000000100000111
111111111111111111111111111111111
111
