



          
F  000, 000, 00
                 C   255,200 ,30
SO ./textures/greystone.xpm
NO ./textures/eagle.xpm

                  
                WE ./textures/purplestone.xpm
                           




 EA          ./textures/red.xpm











11111111111111111111111111111111
        111
111111111000100000000000011111
1000000000S0000000111000100001
11000010000000000000000011101
100001111111000001000111111
11111100000000010000000000001
1111000000001110000001000011
1100000000000111111111111111
11111111111111111111111111111
1000000000001111111110000010011
1100000000001100000010001111001
11000000000111000000100000111
111111111111111111111111111111111
111
111