



          
F  000, 255, 00
                 C   255 ,200, 214
SO ./textures/greystone.xpm
NO ./textures/eagle.xpm

                  
                WE ./textures/purplestone.xpm
                           




 EA          ./textures/red.xpm









11111111111111111111111111111111111111111
       111 111111111100000000000000000000111
11111110001000000000000111000111111111111
10000000000000001110001000011111
110000100000000000000000111011
10000111111100000100011111111
11111100000010010000000000001
111100000N001110000001000011
1100000000000111111111111111
11111111111111111111111111111
100000000000111111111000001001
1100000000001100000010001111001
110000000001110000001000001111
111111111111111111111111111111111
111
111